####################
#                  #
# ###  ### ### ### #
# # #  ### #       #
# ###  ### ####### #
#                  # 
# # ###### ####### #
# #      # #     # #
# #####  #       # #
#        # #     # #
# ############# ## #
#   #       #      #
#   #       # T    #
# ### #### #### ## #
###    #         # #
# #### ### #### ## #
# #    #         ###
# ## ############# #
#                  #
####################